:ID:
X:0
Y:0
:/ID:

:Key:
0 = Nothing
1 = Grass
2 = Bounce
3 = Damage
A = Anchor
P = Player Spawn
E = Enemy Spawn
T = Golden Chest
:/Key:

:Map:
0 0 0 0 0 0 0 0 0 0 0 0 0 0 0 0
0 0 0 0 0 0 0 0 0 0 0 0 0 0 0 0
0 0 0 0 0 0 0 0 0 0 0 0 0 0 0 0
0 0 0 0 0 0 0 0 0 0 0 0 0 0 0 0
1 1 1 1 1 1 1 1 0 0 0 0 0 0 0 0
1 0 0 0 0 0 0 1 1 1 1 0 0 0 0 0
1 0 P 0 0 0 0 0 0 0 1 1 1 1 0 0
1 1 1 1 1 0 0 0 0 0 0 0 0 1 1 1
0 0 0 0 1 1 1 1 0 0 0 0 0 0 0 0
0 0 0 0 0 0 0 1 1 1 1 0 0 0 0 0
0 0 0 0 0 0 0 0 0 0 1 1 1 1 0 0
0 0 0 0 0 0 0 0 0 0 0 0 0 1 1 1
:/Map:

:Notes:
800 x 600 screen at 50px 50px = 16 accross and 12 down
:/Notes: