:ID:
X:3
Y:0
:/ID:

:Key:
0 = Nothing
1 = Grass
2 = Bounce
3 = Damage
A = Anchor
P = Player Spawn
T = Golden Chest
E = Enemy Spawn
:/Key:

:Map:
0 0 0 0 0 0 0 0 0 0 0 0 0 0 0 0
0 0 0 0 0 0 0 A 0 0 0 0 0 0 0 0
0 0 0 0 0 0 0 0 0 0 0 0 0 0 0 0
0 0 0 0 0 0 0 0 0 0 0 0 0 0 0 0
P 0 0 0 0 0 0 0 0 0 0 0 0 0 0 0
1 1 1 1 1 0 0 0 0 0 0 1 1 1 1 1
0 0 0 0 1 0 0 0 0 0 0 1 0 0 0 0
0 0 0 0 1 0 0 0 0 0 0 1 0 0 0 0
0 0 0 0 1 0 0 0 0 0 0 1 0 0 0 0
0 0 0 0 1 0 0 0 0 0 0 1 0 0 0 0
0 0 0 0 1 3 3 3 3 3 3 1 0 0 0 0
0 0 0 0 1 1 1 1 1 1 1 1 0 0 0 0
:/Map:

:Notes:
800 x 600 screen at 50px 50px = 16 accross and 12 down
:/Notes: